-18
19
-12
9
00000000000000000000000000000000000000
11111111111111111111111111111111111100
11111111111111111111111111111111111100
11111111111111111111111111111111111100
11111111111111111111111111111111111100
11110000000000000000000000000000111100
11110000000000000000000000000000111100
11110000000000000000000011111110111100
11110000000000000000000011111110111100
11110000001100000000000011111110111100
11110000000100100000000011111110111100
11110000000100000000000011111110111100
11110000000101010000000011111110111100
11110000000101110000000011111110111100
11110000001110000000000000000000111100
11110000001110000000000000000000111100
11110000000000000000000000000000111100
11110000000000000000000000000000111100
11111111111111111111111111111111111100
11111111111111111111111111111111111100
11111111111111111111111111111111111100
11111111111111111111111111111111111100
